0;50;true;true;9.1
*****11e111e111*****
**e777e777e777e777**
*e666e666e666e666e6*
e222e222e222e222e222
666e666e666e666e666e
77e777e777e777e777e7
*e111e111e111e111e1*
**77e777e777e777e7**
**6e666e666e666e66**
*****2e222e222e*****