0;0;true;true;8.5
****ee********ee****
**eG**e******e**Ge**
*eG7GG*e****e*GG7Ge*
e77777G*e**e*G77777e
66666e7G*ee*G7e66666
444446e7G**G7e644444
PPee446e7GG7e644eePP
e2PPe446e77e644ePP2e
1e22Pe446ee644eP22e1
g1e22Pe446644eP22e1g
*g1e22Pe4444eP22e1g*
**g1e22Pe44eP22e1g**
***g1e22PeeP22e1g***
****g1e22PP22e1g****
*****g1e2222e1g*****
******g1e11e1g******
*******g1ee1g*******
********gggg********