0;50;true;true;9
*e*****7777*****e*
*5****77ee77****5*
*5***7eeeeee7***5*
*5****77ee77****5*
*5*****7777*****5*
*g55558888885555g*
gegggg866668ggggeg
geeeee86ee68eeeeeg
geeeee8ewwe8eeeeeg
gegggg86ee68ggggeg
*g11118888881111g*
*1*****7777*****1*
*1****77ee77****1*
*1***7eeeeee7***1*
*1****77ee77****1*
*e*****7777*****e*