0;0;true;true;8
*******1e282e1*******
******1e23832e1******
*****1e238e832e1*****
****1e2D**8**D2e1****
***1e2ee34543ee2e1***
**1e2222222222222e1**
*1eeeeeeeeeeeeeeeee1*
111111111111111111111
*1eeeeeeeeeeeeeeeee1*
**1e2222222222222e1**
***1e2ee34543ee2e1***
****1e2D**8**D2e1****
*****1e238e832e1*****
******1e23832e1******
*******1e282e1*******